#..#.........#####..............
#..#.........#####..............
#..#.........#####..............
#..#............................
#..#............................
#..#.........#####..............
#..#.........#####..............
#..#.........#####..............
#..##..#############..#####..###
#..##..#############..#####..###
........##........##..##........
........##........##..##........
........##........##............
........##........##............
........##........##..##........
........##........##..##........
........######..####..#####..###
........######..####..#####..###
........######........##........
........######........##........
####..########..########........
####..########..########........
####............########........
####............########........





