#..#############################
#..#.........#####.............#
#..#.........#####...!!........#
#..#.................!!........#
#..#.....................!!....#
#..#.........#####.......!!....#
#..#.........#####.............#
#..#.........#####.............#
#..##..#############..#####..###
#..##..#############..#####..###
#.......##........##..##.......#
#.......##........##..##.......#
#.......##........##...........#
#.......##........##...........#
#.......##........##..##.......#
#....!!.##........##..##.......#
#....!!.######..####..#####..###
#.......######..####..#####..###
#.......######........##.......#
#.......######........##.......#
####..########..########.......#
####..########..########.......#
####............########.......#
########################.......#





