###########..###################
#..#.........#####.............#
#..#.........#####.............#
#..#.....#########.......##....#
#..#...!!................##.!!.#
#..#...!!................##.!!.#
#..#.........#####......###....#
#..#...!!....#####......###....#
#..#...!!...########....###....#
#..#........########....###....#
#..#....##..##....##....###....#
#..#....##..##....##....###....#
#..#....##..##....##..#####....#
#.......##..##....##..##.....###
#.......##........##.........###
#..#######........##.........###
#..###########..####..####...###
#..#............####..####...###
#..#............##....##.......#
#..###########..##....##.......#
#......#######..########.......#
#...............########.......#
####............########.......#
########################.......#