###########..###################
#..#.........#####.............#
#..#.........#####.............#
#..#.....#########.......##....#
#..#...!!................##.!!.#
#..#...!!................##.!!.#
#..#.........#####......###....#
#..#...!!....#####......###....#
#..#...!!...########....###....#
#..#........########....###....#
#..#....##..##....##....###....#
#..#....##..##....##....###....#
#..#....##..##.!!.##..#####....#
#.......##..##.!!.##..##.....###
#.......##........##.........###
#...######........##.........###
#...##########..####..####...###
#..#............####..###....###
#..###..........##!!..##.......#
#.....########..##!!..##.......#
####..########..########.......#
####............########.......#
####............########.......#
########################.......#