#..#############################
#..#.........#####.............#
#..#.........#####...!!........#
#..#.........#####...!!........#
#..#.........#####.......!!....#
#..#.........#####.......!!....#
#..#.........#####.............#
#..#.........#####.............#
#..#........########..#####..###
#..#........########..#####..###
#.......##............##.......#
#.......##............##.......#
#.......##............##.......#
#.......##........##..##.......#
#.......##........##..##.......#
#....!!.##........##..##.......#
#....!!.######..####..#####..###
#.......######..####..#####..###
#.......######........##.......#
#.......######........##.......#
####..##################.......#
####..##################.......#
####............########.......#
########################.......#





