#..#############################
#..#.........#####.............#
#..#.........#####...!!........#
#..#..........##.....!!........#
#..#..........##.........!!....#
#..#.........#####.......!!....#
#..#.........#####.............#
#..#.........#####.............#
#..##..##...########..#####..###
#..##..##...########..#####..###
#.......##........##..##.......#
#.......##............##.......#
#.......##............##.......#
#.......##........##..##.......#
#.......##........##..##.......#
#....!!.##........##..##.......#
#....!!.######..####..#####..###
#.......######..####..#####..###
#.......######........##.......#
#.......######........##.......#
####..##################.......#
####..########..########.......#
####............########.......#
########################.......#





